.......i......x.
..xxxx.....xxxx.
..x...........c.
x.x.c..xxxx.....
..xxxxxx........
..c..c.......xxx
....xxx......x.c
.........c...x..
xx.xx......xxx..
...cx...........
....xxxxx.......
.......g........