.......i......c.
..xxx......xxxx.
...c............
................
xxxx...c........
.............xxx
..c.............
............c...
xxxxx...........
.c..............
.......xxxxxxx..
..c....g........